wwwwwwwwwwwwwwwwwwwwwwwwwwwwwwwwwwwwwwwwwwwww
w...........................................w
w..5...............................3........w
w.......wwwwwww..........wwwwwwwww..........w
w.......w........................w..........w
w.......w...........6............w..........w
w.......w........................w..........w
w.......w...................................w
w.......w......wwww.....w...................w
w.......w......w1.......w...................w
w..............w1.......w...................w
w...............1...C...w...................w
w...............1...........................w
w..9....w......w1...........wwwwwwww........w
w.......w......w11111111..9......www........w
w.......w......wwwww..www.......9.ww........w
w.......w................... ww....w........w
w........w.................. ww9...w........w
w.........w................. ww....w........w
w..........ww...........wwwwwww ...w........w
w.................................ww........w
w.................................     .....w
w.............................wwwwwwwwww....w
w...........................................w
w...........................................w
w...........................................w
w...........................................w
w..................................7........w
wwwwwwwwwwwwwwwwwwwwwwwwwwwwwwwwwwwwwwwwwwwww
