wwwwwwwwwwwwwwwwwwwwwwwwwwwwwwwwwwwwwwwwwwwwwwwwwwwwwwwwwwwwwwwwwwwwwwwwwwwww
w...........................................................................w
w...........................................................................w
w...........................................................................w
w...........................................................................w
w...........................................................................w
w...........................................................................w
w...........................................................................w
w...............wwww...................................wwww.................w
w..............w...........................................w................w
w.............w.............................................w...............w
w............w...............................................w..............w
w............w...............................................w..............w
w............w...............................................w..............w
w............w.......................3.......................w.....1........w
w............w...............................................w..............w
w............w...............................................w..............w
w............w...............................................w..............w
w............w...............................................w..............w
w............w...............................................w..............w
w............w...............................................w..............w
w............w...............wwwwwwwwwwwwww...ww.............w..............w
w............w.................w... ......w..ww..............w..............w
w.........www..................w...     ..www.................www...........w
w.......www..9.................w... ......w.www.................www.........w
w.........www..................w...     ..w...ww..............www...........w
w............w...............................................w..............w
w............w...............................................w..............w
w............w...............................................w..............w
w............w...............................................w..............w
w............w.................             .................w.......3......w
w............w............................. .................w..............w
w............w.......................9..... .................w..............w
w............w............................. .................w..............w
w............w.................             .................w..............w
w............w................. .............................w..............w
w............w................. .............................w..............w
w............w................. .............................w..............w
w.............w................ ............................w...............w
w..............w............... ...........................w................w
w...............wwww........... .......................wwww.................w
w.............................. ............................................w
w..............................  ...........................................w
w........11111.................  ........................2..................w
w..............................             ................................w
w...........................................................................w
w...........................................................................w
w...........................................................................w
w...........................................................................w
wwwwwwwwwwwwwwwwwwwwwwwwwwwwwwwwwwwwwwwwwwwwwwwwwwwwwwwwwwwwwwwwwwwwwwwwwwwww