wwwwwwwwwwwwwwwwwwwwwwwwwwwwwwwwwwwwwwww
w.................  ...................w
w.................  ...............9...w
w.......www............................w
w.......w.........  ...................w
w.......w.........  ...................w
w.................  ...................w
w.................ww...................w
w.................ww...................w
w.................  ...................w
w.................  ...................w
w......................................w
w.................  ...................w
w..9..............  ...................w
w.................  ...................w
w......................................w
w............................w.........w
w...........................w..1.......w
w............................w.........w
w.......................wwwwww.........w
w......................................w
w......................................w
w......................................w
wwwwwwwwwwwwwwwwww  wwwwwwwwwwwwwwwwwwww
