wwwwwwwwwwwwwwwwwwwwwwwwwwwwwwwwwwwwwwwwwwwwwwwwwwwwwww
w.....................w...............................w
w.........4...........w...............................w
w.....................w...............................w
w.....................w...............................w
w.....................w...2...........................w
w.....................w...............................w
w.....................w.........A.....................w
w.....................w...............................w
w.........6...........wwwwwwwwwwwwwwwww...............w
w..................................2..................w
w.....................................................w
w.....................................................w
w.....................................................w
w..............wwwwwwwwwwww...........................w
w.........................w............9..............w
w.........................w...........................w
w.....C...................w...........................w
w.........................w...........................w
w....................5....w..............ww...........w
w.........................w...............ww..........w
w.........................w................ww.........w
w.........................w................ww.........w
w...............wwwwwwwwwww.........1.....ww..........w
w........3......w........................ww...........w
w...............w........................ww..G........w
w..........wwwwwwww.......................ww..........w
w.........ww...............................ww.........w
w........ww.C...............................ww........w
w.......wwwwwwwwwwwww.......3.........................w
w.....................................................w
wwwwwwwwwwwwwwwwwwwwwwwwwwwwwwwwwwwwwwwwwwwwwwwwwwwwwww
