wwwwwwwwwwwwwwww
w.......¿......w
w.1..........6.w
w....... ......w
w....... ......w
w..A........z..w
w..............w
wwwwwwwwwwwwwwww
