wwwwwwwwwwwwwwwwww  wwwwwwwwwwwwwwwwwwww
w.................  ...................w
w.....2...........  ...............1...w
w..................9...................w
w.................  ...................w
w.................  ...................w
w.................  ...................w
w.................  ...................w
w.................  ...................w
w.................  ...................w
w.................  ...................w
w..................8..............3....w
w.................  ...................w
w..4..............  ...................w
w.................  ...................w
wwwwwwwwwwwwwwwwww  wwwwwwwwwwwwwwwwwwww
